<'Gator_Bait>	<Beverly_Sebastion>
<A.I._Artificial_Intelligence>	<Steven_Spielberg>
<Aadhavan>	<K._S._Ravikumar>
<Aadu_Puli>	<Vijay_Prakash>
<Aakasha_Ganga>	<Vinayan>
<Aalavandhan>	<Suresh_Krishna_(director)>
<Aaraam_Thampuran>	<Shaji_Kailas>
<Aavanazhi>	<I._V._Sasi>
<Ab-normal_Beauty>	<Pang_brothers>
<Abby_in_Wonderland>	<Kevin_Clash>
<Abraxas,_Guardian_of_the_Universe>	<Damian_Lee>
<Acción_mutante>	<Álex_de_la_Iglesia>
<Adhu>	<Ramesh_Krishnan>
<Adiverukal>	<P._Anil>
<Adventure's_End>	<Arthur_Lubin>
<Aegan>	<Raju_Sundaram>
<Aelita>	<Yakov_Protazanov>
<Aenigma_(film)>	<Lucio_Fulci>
<Aetbaar>	<Vikram_Bhatt>
<Aguirre,_the_Wrath_of_God>	<Werner_Herzog>
<Agyaat>	<Ram_Gopal_Varma>
<Airbag_(film)>	<Juanma_Bajo_Ulloa>
<Air_Mail_(film)>	<John_Ford>
<Alaska_(film)>	<Fraser_Clarke_Heston>
<Albino_(film)>	<Jürgen_Goslar>
<Alice,_Sweet_Alice>	<Alfred_Sole>
<Aliens_in_the_Attic>	<John_Schultz_(director)>
<Alien_Abduction_(film)>	<Eric_Forsberg>
<Alien_Dead>	<Fred_Olen_Ray>
<Alien_Nation_(film)>	<Graham_Baker_(director)>
<Alligator_(film)>	<Jon_Hess_(director)>
<Alligator_(film)>	<Lewis_Teague>
<All_About_Evil>	<Peaches_Christ>
<All_Souls_Day_(film)>	<Jeremy_Kasten>
<Almost_Heroes>	<Christopher_Guest>
<Altered_States>	<Ken_Russell>
<Amar_Akbar_Anthony>	<Manmohan_Desai>
<American_History_X>	<Tony_Kaye_(director)>
<Among_the_Living_(film)>	<Stuart_Heisler>
<Amsterdamned>	<Dick_Maas>
<Anatomy_(film)>	<Stefan_Ruzowitzky>
<Andy_Warhol's_Frankenstein>	<Paul_Morrissey>
<And_Now_the_Screaming_Starts!>	<Roy_Ward_Baker>
<Angaar>	<Shashilal_K._Nair>
<Angels_Revenge>	<Greydon_Clark>
<Anguish_(film)>	<Bigas_Luna>
<Antichrist_(film)>	<Lars_von_Trier>
<Anukokunda_Oka_Roju>	<Chandra_Sekhar_Yeleti>
<An_American_Haunting>	<Courtney_Solomon>
<An_American_Werewolf_in_London>	<John_Landis>
<Aptharakshaka>	<P._Vasu>
<Arabian_Adventure>	<Kevin_Connor_(director)>
<Arcade_(film)>	<Albert_Pyun>
<Arizona_Dream>	<Emir_Kusturica>
<Armour_of_God_(film)>	<Eric_Tsang>
<Armour_of_God_(film)>	<Jackie_Chan>
<Ashok_(film)>	<Surender_Reddy>
<Assassination_Games>	<Ernie_Barbarash>
<Assault_of_Darkness>	<Brendan_Foley>
<Asterix_&_Obelix_Take_On_Caesar>	<Claude_Zidi>
<Athadu>	<Trivikram_Srinivas>
<Atom_Age_Vampire>	<Anton_Giulio_Majano>
<Attack_of_the_Crab_Monsters>	<Roger_Corman>
<Attack_of_the_Giant_Leeches>	<Bernard_L._Kowalski>
<Attack_of_the_Puppet_People>	<Bert_I._Gordon>
<At_Midnight_I'll_Take_Your_Soul>	<José_Mojica_Marins>
<At_the_Earth's_Core_(film)>	<Kevin_Connor_(director)>
<Audition_(film)>	<Takashi_Miike>
<Automatons>	<James_Felix_McKenney>
<Auzaar>	<Sohail_Khan>
<Au_Secours!>	<Abel_Gance>
<Avenging_Force>	<Sam_Firstenberg>
<Avinash_(film)>	<Umesh_Mehra>
<Awake_(film)>	<Joby_Harold>
<A_Better_Tomorrow>	<John_Woo>
<A_Bittersweet_Life>	<Kim_Ji-woon>
<A_Blade_in_the_Dark>	<Lamberto_Bava>
<A_Blind_Bargain>	<Wallace_Worsley>
<A_Cat_in_the_Brain>	<Lucio_Fulci>
<A_Challenge_for_Robin_Hood>	<C.M._Pennington-Richards>
<A_Dirty_Carnival>	<Yoo_Ha>
<A_Family_Torn_Apart>	<Craig_R._Baxley>
<A_Far_Off_Place>	<Mikael_Salomon>
<A_Lonely_Place_to_Die>	<Julian_Gilbey>
<A_Man_Apart>	<F._Gary_Gray>
<A_Nightmare_on_Elm_Street>	<Wes_Craven>
<A_Prize_of_Gold>	<Mark_Robson>
<A_Prize_of_Gold>	<Max_Catto>
<A_Quiet_Place_in_the_Country>	<Elio_Petri>
<A_Return_to_Salem's_Lot>	<Larry_Cohen>
<A_Scandal_in_Paris>	<Douglas_Sirk>
<A_Trip_to_the_Moon>	<Georges_Méliès>
<A_Twist_of_Sand>	<Don_Chaffey>
<A_Wrinkle_in_Time_(film)>	<John_Kent_Harrison>
<Baba_Kalyani_(film)>	<Shaji_Kailas>
<Bachelor_Party_Vegas>	<Eric_Bernt>
<Backdraft_(film)>	<Ron_Howard>
<Backfire_(film)>	<Gilbert_Cates>
<Badlands_(film)>	<Terrence_Malick>
<Bad_Boys_II>	<Michael_Bay>
<Bad_Dreams_(film)>	<Andrew_Fleming>
<Bad_Moon>	<Eric_Red>
<Baghead>	<Jay_Duplass>
<Baghead>	<Mark_Duplass>
<Balto_(film)>	<Simon_Wells>
<Bandits>	<Barry_Levinson>
<Bang_(film)>	<Ash_Baron-Cohen>
<Basement_Jack>	<Michael_Shelton>
<Basket_Case_(film)>	<Frank_Henenlotter>
<Batang_X>	<Peque_Gallaga>
<Batman_&_Robin_(film)>	<Joel_Schumacher>
<Battle_Beyond_the_Stars>	<Jimmy_Murakami>
<Battle_of_the_Worlds>	<Antonio_Margheriti>
<Beast_from_Haunted_Cave>	<Monte_Hellman>
<Bedevil>	<Tracey_Moffatt>
<Bedlam_(film)>	<Mark_Robson>
<Beetlejuice>	<Tim_Burton>
<Beginning_of_the_End>	<Bert_I._Gordon>
<Below_(film)>	<David_Twohy>
<Belphegor,_Phantom_of_the_Louvre>	<Jean-Paul_Salomé>
<Beneath_Still_Waters>	<Brian_Yuzna>
<Benji_(film)>	<Joe_Camp>
<Benny's_Video>	<Michael_Haneke>
<Ben_(film)>	<Phil_Karlson>
<Berserk!>	<Jim_O'Connolly>
<Best_Guy>	<Toru_Murakawa>
<Beverly_Hills_Chihuahua>	<Raja_Gosnell>
<Beyond_Re-Animator>	<Brian_Yuzna>
<Beyond_the_Limits_(film)>	<Olaf_Ittenbach>
<Bhargavi_Nilayam>	<A._Vincent>
<Bhool_Bhulaiyaa>	<Priyadarshan>
<Big_Bullet>	<Benny_Chan_(film_director)>
<Bikini_Bloodbath>	<Thomas_Edward_Seymour>
<Billi>	<Syed_Noor>
<Bill_&_Ted's_Bogus_Journey>	<Peter_Hewitt_(film_director)>
<Bill_&_Ted's_Excellent_Adventure>	<Stephen_Herek>
<Bio_Zombie>	<Wilson_Yip>
<Black_God,_White_Devil>	<Glauber_Rocha>
<Black_Sabbath_(film)>	<Mario_Bava>
<Black_Swarm>	<David_Winning>
<Blind_Beast_vs._Dwarf>	<Teruo_Ishii>
<Blood_&_Chocolate_(film)>	<Katja_von_Garnier>
<Blood_Beach>	<Jeffrey_Bloom>
<Blood_Diamond_(film)>	<Edward_Zwick>
<Blood_for_Dracula>	<Paul_Morrissey>
<Blood_Freak>	<Brad_F._Grinter>
<Blood_from_the_Mummy's_Tomb>	<Seth_Holt>
<Blood_Monkey>	<Robert_Young_(director)>
<Blood_of_Ghastly_Horror>	<Al_Adamson>
<Blood_Song>	<Alan_J._Levi>
<Blue_City_(film)>	<Michelle_Manning>
<Blue_Streak_(film)>	<Les_Mayfield>
<Blue_Sunshine_(film)>	<Jeff_Lieberman>
<Body_Jumper>	<Haeman_Chatemee>
<Body_Parts_(film)>	<Eric_Red>
<Book_of_Blood>	<John_Harrison_(filmmaker)>
<Bordello_of_Blood>	<Gilbert_Adler>
<Born_American>	<Renny_Harlin>
<Boulevard_du_Rhum>	<Robert_Enrico>
<Brainscan>	<John_Flynn_(director)>
<Brain_Damage_(film)>	<Frank_Henenlotter>
<Bram_Stoker's_Dracula's_Curse>	<Leigh_Scott>
<Branded_to_Kill>	<Seijun_Suzuki>
<Bride_of_Chucky>	<Ronny_Yu>
<Bride_of_Frankenstein>	<James_Whale>
<Bride_of_Re-Animator>	<Brian_Yuzna>
<Bride_of_the_Gorilla>	<Curt_Siodmak>
<Bride_of_the_Monster>	<Ed_Wood>
<Bronson_(film)>	<Nicolas_Winding_Refn>
<Brotherhood_of_Blood>	<Peter_Scheerer>
<Brotherhood_of_Blood>	<Michael_Roesch>
<Bryan_Loves_You>	<Seth_Landau>
<Bullets_or_Ballots>	<William_Keighley>
<Buppah_Rahtree>	<Yuthlert_Sippapak>
<Burnt_Offerings_(film)>	<Dan_Curtis>
<Bushido,_Samurai_Saga>	<Tadashi_Imai>
<By_Dawn's_Early_Light>	<Jack_Sholder>
<Cabeza_de_Vaca_(film)>	<Nicolás_Echevarría>
<California_Straight_Ahead!>	<Arthur_Lubin>
<Calvaire_(film)>	<Fabrice_Du_Welz>
<Cameron's_Closet>	<Armand_Mastroianni>
<Camp_Blood>	<Brad_Sykes>
<Candyman_(film)>	<Bernard_Rose_(director)>
<Cannibal!_The_Musical>	<Trey_Parker>
<Cannibal_Girls>	<Ivan_Reitman>
<Can_of_Worms_(film)>	<Paul_Schneider_(director)>
<Captain_Calamity_(film)>	<John_Reinhardt>
<Captain_Thunderbolt_(film)>	<Cecil_Holmes_(director)>
<Carnival_of_Souls>	<Herk_Harvey>
<Carnosaur_(film)>	<Adam_Simon>
<Carry_On_Screaming!>	<Gerald_Thomas>
<Casper_Meets_Wendy>	<Sean_McNamara_(director)>
<Casshern_(film)>	<Kazuaki_Kiriya>
<Castle_Freak>	<Stuart_Gordon>
<Castle_of_Blood>	<Antonio_Margheriti>
<Cast_a_Deadly_Spell>	<Martin_Campbell>
<Cat-Women_of_the_Moon>	<Arthur_Hilton>
<Catch_That_Kid>	<Bart_Freundlich>
<Cavaleiro_Negro>	<Luiz_de_Barros>
<Cellar_Dweller>	<John_Carl_Buechler>
<Centigrade_(film)>	<Colin_Cunningham>
<Certain_Fury>	<Stephen_Gyllenhaal>
<Chainsaw_Scumfuck>	<Alex_Chandon>
<Chandramukhi>	<P._Vasu>
<Charlie_Chan_in_Panama>	<Norman_Foster_(director)>
<Chemical_Wedding_(film)>	<Julian_Doyle_(filmmaker)>
<Chernobyl_Diaries>	<Brad_Parker>
<Cherry_Tree_Lane>	<Paul_Andrew_Williams>
<Children_Shouldn't_Play_with_Dead_Things>	<Bob_Clark>
<China_O'Brien_II>	<Robert_Clouse>
<Chopping_Mall>	<Jim_Wynorski>
<Circus_of_Horrors>	<Sidney_Hayers>
<City_Hunter_(film)>	<Wong_Jing>
<City_of_Ember>	<Gil_Kenan>
<City_of_the_Living_Dead>	<Lucio_Fulci>
<Closed_for_the_Season>	<Jay_Woelfel>
<Close_Encounters_of_the_Third_Kind>	<Steven_Spielberg>
<Clothes_Make_the_Pirate>	<Maurice_Tourneur>
<Cloverfield>	<Matt_Reeves>
<Clownhouse>	<Victor_Salva>
<Club_Dread>	<Jay_Chandrasekhar>
<Colors_(film)>	<Dennis_Hopper>
<Commissioner_(film)>	<Shaji_Kailas>
<Condemned_to_Death>	<Walter_Forde>
<Congo_Crossing>	<Joseph_Pevney>
<Convicted_Woman>	<Nick_Grinde>
<Con_Air>	<Simon_West>
<Cool_Runnings>	<Jon_Turteltaub>
<Cornered!_(film)>	<Daniel_Maze>
<Corvette_Summer>	<Matthew_Robbins_(screenwriter)>
<Countess_Dracula>	<Peter_Sasdy>
<Cradle_of_Fear>	<Alex_Chandon>
<Creature_from_the_Haunted_Sea>	<Roger_Corman>
<Creepozoids>	<David_DeCoteau>
<Crescendo_(film)>	<Alan_Gibson_(director)>
<Critters_(film)>	<Stephen_Herek>
<Cronos_(film)>	<Guillermo_del_Toro>
<Cruise_of_the_Jasper_B>	<James_W._Horne>
<Crying_Freeman_(film)>	<Christophe_Gans>
<Cube_(film)>	<Vincenzo_Natali>
<Cube_Zero>	<Ernie_Barbarash>
<Cult_of_the_Cobra>	<Francis_D._Lyon>
<Curse_of_the_Puppet_Master>	<David_DeCoteau>
<Cut_(film)>	<Kimble_Rendall>
<D-Tox>	<Jim_Gillespie>
<D.A.R.Y.L.>	<Simon_Wincer>
<Dabangg>	<Abhinav_Kashyap>
<Daddy's_Deadly_Darling>	<Marc_Lawrence>
<Damnation_Alley_(film)>	<Jack_Smight>
<Dance_Macabre_(film)>	<Greydon_Clark>
<Daredevil_(film)>	<Mark_Steven_Johnson>
<Darklands_(film)>	<Julian_Richards_(director)>
<Dark_Blue_(film)>	<Ron_Shelton>
<Dark_Floors>	<Pete_Riski>
<Dark_Harvest>	<Paul_Moore>
<Dark_Intruder>	<Harvey_Hart>
<Darr>	<Yash_Chopra>
<Da_Hip_Hop_Witch>	<Dale_Resteghini>
<Deadly_Eyes>	<Robert_Clouse>
<Deadly_Friend>	<Wes_Craven>
<Dead_&_Breakfast>	<Matthew_Leutwyler>
<Dead_&_Buried>	<Gary_Sherman_(director)>
<Dead_Man's_Bluff>	<Aleksei_Balabanov>
<Dead_Men_Walk>	<Sam_Newfield>
<Dead_of_Night>	<Basil_Dearden>
<Dead_of_Night>	<Charles_Crichton>
<Dead_of_Night>	<Alberto_Cavalcanti>
<Dead_of_Night>	<Robert_Hamer>
<Dead_Ringers_(film)>	<David_Cronenberg>
<Dead_Snow>	<Tommy_Wirkola>
<Dead_Tone>	<Deon_Taylor>
<Dead_Tone>	<Brian_Hooks>
<Deathdream>	<Bob_Clark>
<Death_at_an_Old_Mansion>	<Yoichi_Takabayashi>
<Death_in_the_Garden>	<Luis_Buñuel>
<Death_Weekend>	<William_Fruet>
<Demonia_(film)>	<Lucio_Fulci>
<Demonium>	<Andreas_Schnaas>
<Demons_Never_Die>	<Arjun_Rose>
<Demons_of_the_Mind>	<Peter_Sykes_(director)>
<Demon_Island>	<Scott_Hillenbrand>
<Demon_Island>	<David_Hillenbrand>
<Densen_Uta>	<Masato_Harada>
<Desperado_(film)>	<Robert_Rodriguez>
<Devadoothan>	<Sibi_Malayil>
<Devasuram>	<I._V._Sasi>
<Devil_Doll_(film)>	<Lindsay_Shonteff>
<Deyyam>	<Ram_Gopal_Varma>
<De_Lift>	<Dick_Maas>
<Dhruvam>	<Joshiy>
<Dick_Tracy's_Dilemma>	<John_Rawlins_(director)>
<Dick_Tracy_Meets_Gruesome>	<John_Rawlins_(director)>
<Dick_Tracy_vs._Cueball>	<Gordon_Douglas_(director)>
<Die,_Monster,_Die!>	<Daniel_Haller>
<Die_Blutgräfin_(film)>	<Ulrike_Ottinger>
<Die_Hard>	<John_McTiernan>
<Dinner_with_a_Vampire>	<Lamberto_Bava>
<Disappearance_(film)>	<Walter_Klenhard>
<Disturbed_(film)>	<Charles_Winkler>
<Disturbing_Behavior>	<David_Nutter>
<Dobermann_(film)>	<Jan_Kounen>
<Docteur_Jekyll_et_les_femmes>	<Walerian_Borowczyk>
<Doctor_Blood's_Coffin>	<Sidney_J._Furie>
<Doctor_Syn_(film)>	<Roy_William_Neill>
<Doghouse_(film)>	<Jake_West>
<Dogma_(film)>	<Kevin_Smith>
<Don't_Go_Near_the_Park>	<Lawrence_D._Foldes>
<Don't_Look_Up>	<Hideo_Nakata>
<Don't_Torture_a_Duckling>	<Lucio_Fulci>
<Donovan's_Brain_(film)>	<Felix_E._Feist>
<Don_Seenu>	<Gopichand_Malineni>
<Dookudu>	<Srinu_Vaitla>
<Doomsday_(film)>	<Neil_Marshall>
<Doomwatch_(film)>	<Peter_Sasdy>
<Down_Twisted>	<Albert_Pyun>
<Do_You_Like_Hitchcock?>	<Dario_Argento>
<Dr._Black,_Mr._Hyde>	<William_Crain_(filmmaker)>
<Dr._Caligari_(film)>	<Stephen_Sayadian>
<Dr._Giggles>	<Manny_Coto>
<Dr._Jekyll_y_el_Hombre_Lobo>	<León_Klimovsky>
<Dr._Phibes_Rises_Again>	<Robert_Fuest>
<Dr._Terror's_House_of_Horrors>	<Freddie_Francis>
<Dracula's_Daughter>	<Lambert_Hillyer>
<Dracula_Has_Risen_from_the_Grave>	<Freddie_Francis>
<Dracula_vs._Frankenstein>	<Al_Adamson>
<Dragons_Forever>	<Corey_Yuen>
<Dragons_Forever>	<Sammo_Hung>
<Dragons_Forever>	<Fruit_Chan>
<Drag_Me_to_Hell>	<Sam_Raimi>
<Dredd>	<Pete_Travis>
<Driftwood_(film)>	<Tim_Sullivan_(director)>
<Drowning_Ghost_(film)>	<Mikael_Håfström>
<Duma_(film)>	<Carroll_Ballard>
<Dumplings_(film)>	<Fruit_Chan>
<Dum_Maaro_Dum_(film)>	<Rohan_Sippy>
<E.T._the_Extra-Terrestrial>	<Steven_Spielberg>
<Each_Time_I_Kill>	<Doris_Wishman>
<Earth_vs._the_Flying_Saucers>	<Fred_F._Sears>
<Earth_vs._the_Spider>	<Bert_I._Gordon>
<Eaten_Alive>	<Tobe_Hooper>
<Echelon_Conspiracy>	<Greg_Marcks>
<Eel_Girl>	<Paul_Campion_(film_director)>
<Ekalavyan_(film)>	<Shaji_Kailas>
<Elephant_White>	<Prachya_Pinkaew>
<Elvira's_Haunted_Hills>	<Sam_Irvin>
<Elysium_(film)>	<Neill_Blomkamp>
<El_Mariachi>	<Robert_Rodriguez>
<El_mundo_de_los_vampiros>	<Alfonso_Corona_Blake>
<Embodiment_of_Evil>	<José_Mojica_Marins>
<Enchanted_(film)>	<Kevin_Lima>
<Enemy_Mine_(film)>	<Wolfgang_Petersen>
<Enter_the_Dragon>	<Robert_Clouse>
<Equilibrium_(film)>	<Kurt_Wimmer>
<Escapee_(film)>	<Campion_Murphy>
<Escape_from_the_Planet_of_the_Apes>	<Don_Taylor_(actor/director)>
<EuroTrip>	<David_Mandel>
<EuroTrip>	<Jeff_Schaffer>
<EuroTrip>	<Alec_Berg>
<Event_Horizon_(film)>	<Paul_W._S._Anderson>
<Evil_Aliens>	<Jake_West>
<Evil_Ambitions>	<Mark_Burchett>
<Evil_Angel_(film)>	<Richard_Dutcher>
<Evil_Cat>	<Dennis_Yu>
<Evil_Dead_II>	<Sam_Raimi>
<Evil_Dead_Trap>	<Toshiharu_Ikeda>
<Evil_Toons>	<Fred_Olen_Ray>
<Evil_Town>	<Mardi_Rustam>
<Exiled>	<Johnnie_To>
<Existenz>	<David_Cronenberg>
<Explorers_(film)>	<Joe_Dante>
<Exposé_(film)>	<James_Kenelm_Clarke>
<Exte>	<Sion_Sono>
<Eyes_Without_a_Face>	<Georges_Franju>
<Eye_of_the_Widow>	<Andrew_McLaglen>
<Face/Off>	<John_Woo>
<Faceless_(film)>	<Jesús_Franco>
<Face_of_the_Screaming_Werewolf>	<Gilberto_Martínez_Solares>
<Face_of_the_Screaming_Werewolf>	<Jerry_Warren>
<Fading_of_the_Cries>	<Brian_Metcalf>
<Falling_Down>	<Joel_Schumacher>
<Fantastic_Voyage>	<Richard_Fleischer>
<Farewell_to_Space_Battleship_Yamato>	<Leiji_Matsumoto>
<Farewell_to_Space_Battleship_Yamato>	<Toshio_Masuda>
<Fargo_(film)>	<Coen_brothers>
<Father_Goose_(film)>	<Ralph_Nelson>
<FBI_Girl>	<William_A._Berke>
<Feast_(film)>	<John_Gulager>
<Female_Vampire>	<Jesús_Franco>
<Fever_Night_aka_Band_of_Satanic_Outsiders>	<Jordan_Harris>
<Fiend_Without_a_Face>	<Arthur_Crabtree>
<Final_Destination>	<James_Wong_(producer)>
<Final_Stab>	<David_DeCoteau>
<Final_Yamato>	<Tomoharu_Katsumata>
<First_Knight>	<Jerry_Zucker_(film_director)>
<First_Target>	<Armand_Mastroianni>
<Fitzcarraldo>	<Werner_Herzog>
<Five_for_Hell>	<Gianfranco_Parolini>
<Five_Minarets_in_New_York>	<Mahsun_K?rm?z?gül>
<Flesheater>	<Bill_Hinzman>
<Flight_of_the_Lost_Balloon>	<Nathan_H._Juran>
<Flight_to_Fury>	<Monte_Hellman>
<Floris_(film)>	<Jean_van_de_Velde_(director)>
<Flowing_Gold>	<Alfred_E._Green>
<Flu_Bird_Horror>	<Leigh_Scott>
<Food_for_the_Gods>	<H._Scott_Hughes>
<Forbidden_Zone>	<Richard_Elfman>
<Force_(film)>	<Nishikant_Kamat>
<Forest_of_the_Damned>	<Johannes_Roberts>
<Forever_Young_(film)>	<Steve_Miner>
<Four_Sided_Triangle>	<Terence_Fisher>
<Frankenhooker>	<Frank_Henenlotter>
<Frankenstein_Conquers_the_World>	<Ishir?_Honda>
<Frankenstein_Created_Woman>	<Terence_Fisher>
<Frankenstein_Meets_the_Space_Monster>	<Robert_J._Gaffney>
<Frankenstein_Meets_the_Wolf_Man>	<Roy_William_Neill>
<Frankenstein_Unbound>	<Roger_Corman>
<Frankenstein_vs._the_Creature_from_Blood_Cove>	<William_Winckler>
<Frauengefängnis>	<Jesús_Franco>
<Freaks>	<Tod_Browning>
<Free_Fall_(film)>	<Mario_Azzopardi>
<Frightmare_(film)>	<Pete_Walker_(director)>
<Fright_Night>	<Tom_Holland_(director)>
<Fright_Night_II>	<Tommy_Lee_Wallace>
<From_Beyond_(film)>	<Stuart_Gordon>
<From_Hell_(film)>	<Hughes_brothers>
<From_Time_to_Time_(film)>	<Julian_Fellowes>
<Frontier(s)>	<Xavier_Gens>
<Fulltime_Killer>	<Johnnie_To>
<Fulltime_Killer>	<Wai_Ka-Fai>
<Full_Moon_High>	<Larry_Cohen>
<Futureworld>	<Richard_T._Heffron>
<Future_Cops>	<Wong_Jing>
<F_(film)>	<Johannes_Roberts>
<Gabbar_Singh_(film)>	<Harish_Shankar>
<Gang_Related>	<Jim_Kouf>
<Genova_(film)>	<Michael_Winterbottom>
<Genuine_(film)>	<Robert_Wiene>
<Ghidorah,_the_Three-Headed_Monster>	<Ishir?_Honda>
<Ghosts…_of_the_Civil_Dead>	<John_Hillcoat>
<Ghost_in_the_Shell_(film)>	<Mamoru_Oshii>
<Ghost_Lake_(film)>	<Jay_Woelfel>
<Ghost_Story_(film)>	<John_Irvin>
<Giant_from_the_Unknown>	<Richard_E._Cunha>
<Gideon's_Day_(film)>	<John_Ford>
<Ginger_Snaps_(film)>	<John_Fawcett_(director)>
<Give_Us_Wings>	<Charles_Lamont>
<Godsend_(film)>	<Nick_Hamm>
<Godzilla_vs._Hedorah>	<Yoshimitsu_Banno>
<Godzilla_vs._the_Sea_Monster>	<Jun_Fukuda>
<God_Told_Me_To>	<Larry_Cohen>
<Golden_Ivory>	<George_Breakston>
<Gone_Fishin'_(film)>	<Christopher_Cain>
<Gor_(film)>	<Fritz_Kiersch>
<Gothic_(film)>	<Ken_Russell>
<Gothika>	<Mathieu_Kassovitz>
<Goy_(film)>	<Felix_Kersting>
<Grace_(film)>	<Paul_Solet>
<Gremlins>	<Joe_Dante>
<Grizzly_(film)>	<William_Girdler>
<Groom_Lake_(film)>	<William_Shatner>
<Growth_(film)>	<Gabriel_Cowan>
<Guncrazy>	<Tamra_Davis>
<Guns_(film)>	<Andy_Sidaris>
<Guns_of_El_Chupacabra>	<Donald_G._Jackson>
<H.M.S._Defiant>	<Lewis_Gilbert>
<Habitat_(film)>	<Rene_Daalder>
<Hair_High>	<Bill_Plympton>
<Halloween_II>	<Rick_Rosenthal>
<Halloween_II>	<John_Carpenter>
<Hancock_(film)>	<Peter_Berg>
<Hangman's_Curse_(film)>	<Rafal_Zielinski>
<Hannibal_Rising_(film)>	<Peter_Webber>
<Happy_Birthday_to_Me_(film)>	<J._Lee_Thompson>
<Hardwired_(film)>	<Ernie_Barbarash>
<Hard_Rain_(film)>	<Mikael_Salomon>
<Hard_Target>	<John_Woo>
<Harold_&_Kumar_Go_to_White_Castle>	<Danny_Leiner>
<Harry_Brown_(film)>	<Daniel_Barber_(director)>
<Harsh_Times>	<David_Ayer>
<Hatchet_(film)>	<Adam_Green_(filmmaker)>
<Haunted_Honeymoon>	<Gene_Wilder>
<Haunting_Sarah>	<Ralph_Hemecker>
<Haywire_(film)>	<Steven_Soderbergh>
<Hellbreeder>	<Johannes_Roberts>
<Helldriver>	<Yoshihiro_Nishimura>
<Hello_Friend>	<Graham_Linehan>
<Hellraiser>	<Clive_Barker>
<Hell_of_the_Living_Dead>	<Bruno_Mattei>
<Hell_of_the_Living_Dead>	<Claudio_Fragasso>
<Her_Dangerous_Path>	<Roy_Clements_(director)>
<Hey,_Stop_Stabbing_Me!>	<Worm_Miller>
<Hideaway_(film)>	<Brett_Leonard>
<High_Road_to_China>	<Brian_G._Hutton>
<Hiruko_the_Goblin>	<Shinya_Tsukamoto>
<Hitch-Hike_(film)>	<Pasquale_Festa_Campanile>
<Hold_That_Ghost>	<Arthur_Lubin>
<Hollywood_Chainsaw_Hookers>	<Fred_Olen_Ray>
<Home_in_Indiana>	<Henry_Hathaway>
<Homicidal>	<William_Castle>
<Honey,_I_Blew_Up_the_Kid>	<Randal_Kleiser>
<Honey,_I_Shrunk_the_Kids>	<Joe_Johnston>
<Honey,_We_Shrunk_Ourselves>	<Dean_Cundey>
<Hook_(film)>	<Steven_Spielberg>
<Hopelessly_Lost>	<Georgiy_Daneliya>
<Horrors_of_the_Black_Museum>	<Arthur_Crabtree>
<Horrorween>	<Joe_Estevez>
<Horror_Hospital>	<Antony_Balch>
<Hot_Potato_(film)>	<Oscar_Williams_(filmmaker)>
<Hot_Tub_Time_Machine>	<Steve_Pink>
<Hour_of_the_Wolf>	<Ingmar_Bergman>
<House_at_the_End_of_the_Street>	<Mark_Tonderai>
<House_of_Dark_Shadows>	<Dan_Curtis>
<House_of_Dracula>	<Erle_C._Kenton>
<House_of_the_Long_Shadows>	<Pete_Walker_(director)>
<House_on_Haunted_Hill>	<William_Castle>
<Howling_III>	<Philippe_Mora>
<Howl_(film)>	<Jeffrey_Friedman_(filmmaker)>
<Howl_(film)>	<Rob_Epstein>
<How_Tasty_Was_My_Little_Frenchman>	<Nelson_Pereira_dos_Santos>
<Humanoids_from_the_Deep>	<Barbara_Peeters>
<Hunting_Season_(film)>	<Yavuz_Turgul>
<Hurricane_Hutch_in_Many_Adventures>	<Charles_Hutchison>
<Hutch_Stirs_'em_Up>	<Frank_Hall_Crane>
<I,_Robot_(film)>	<Alex_Proyas>
<Iceman_(film)>	<Fred_Schepisi>
<Identity_Crisis_(film)>	<Melvin_Van_Peebles>
<If_All_the_Guys_in_the_World>	<Christian-Jaque>
<Impostor_(film)>	<Gary_Fleder>
<Indrajaalam>	<Thampi_Kannanthanam>
<Infernal_Affairs_II>	<Alan_Mak>
<Infernal_Affairs_II>	<Andrew_Lau>
<Infernal_Affairs_III>	<Alan_Mak>
<Infernal_Affairs_III>	<Andrew_Lau>
<Infestation_(film)>	<Kyle_Rankin>
<Initial_D_(film)>	<Alan_Mak>
<Initial_D_(film)>	<Andrew_Lau>
<Inkubus>	<Glenn_Ciano>
<Inner_Senses>	<Law_Chi-leung>
<Inseminoid>	<Norman_J._Warren>
<Insidious_(film)>	<James_Wan>
<Inspector_Balram>	<I._V._Sasi>
<Into_the_West_(film)>	<Mike_Newell_(director)>
<Into_the_Wild_(film)>	<Sean_Penn>
<Invasion_of_the_Bee_Girls>	<Denis_Sanders>
<Invasion_of_the_Saucer_Men>	<Edward_L._Cahn>
<Invisible_Agent>	<Edwin_L._Marin>
<In_Dreams_(film)>	<Neil_Jordan>
<In_Ghost_House_Inn>	<Lal_(actor)>
<In_the_Mouth_of_Madness>	<John_Carpenter>
<Iron_Will>	<Charles_Haid>
<Ishtar_(film)>	<Elaine_May>
<It!_The_Terror_from_Beyond_Space>	<Edward_L._Cahn>
<It_Came_from_Outer_Space>	<Jack_Arnold_(director)>
<It_Conquered_the_World>	<Roger_Corman>
<It_Happened_at_the_World's_Fair>	<Norman_Taurog>
<I_Come_in_Peace>	<Craig_R._Baxley>
<I_Corrupt_All_Cops>	<Wong_Jing>
<I_Don't_Want_to_Be_Born>	<Peter_Sasdy>
<I_Drink_Your_Blood>	<David_E._Durston>
<I_Eat_Your_Skin>	<Del_Tenney>
<I_Know_What_You_Did_Last_Summer>	<Jim_Gillespie>
<I_Spit_on_Your_Grave>	<Meir_Zarchi>
<I_Still_Know_What_You_Did_Last_Summer>	<Danny_Cannon>
<I_Walked_with_a_Zombie>	<Jacques_Tourneur>
<I_Was_a_Teenage_Frankenstein's_Roommate>	<Worm_Miller>
<I_Was_a_Teenage_Frankenstein>	<Herbert_L._Strock>
<I_Went_Down>	<Paddy_Breathnach>
<I_Will_Repay_(film)>	<Henry_Kolker>
<Jack's_Back>	<Rowdy_Herrington>
<Jacob's_Ladder_(film)>	<Adrian_Lyne>
<Jai_Veeru>	<Puneet_Sira>
<JCVD>	<Mabrouk_El_Mechri>
<Jennifer's_Body>	<Karyn_Kusama>
<Jennifer_(film)>	<Brice_Mack>
<Johnny_Angel>	<Edwin_L._Marin>
<John_Dies_at_the_End_(film)>	<Don_Coscarelli>
<Jumanji>	<Joe_Johnston>
<Jurassic_Park_(film)>	<Steven_Spielberg>
<Just_Visiting_(film)>	<Jean-Marie_Poiré>
<Kaalai>	<Tarun_Gopi>
<Kaante>	<Sanjay_Gupta_(director)>
<Kamillions>	<Mike_B._Anderson>
<Kana_Kanmani>	<Akku_Akbar>
<Kashmeeram>	<Rajiv_Anchal>
<Kids_(film)>	<Larry_Clark>
<Killer_Bash>	<David_DeCoteau>
<Killer_Movie>	<Jeff_Fisher>
<Killpoint>	<Frank_Harris>
<Kim_(film)>	<Victor_Saville>
<King_Cobra_(film)>	<David_Hillenbrand>
<King_Cobra_(film)>	<Scott_Hillenbrand>
<King_Dinosaur>	<Bert_I._Gordon>
<King_of_the_Khyber_Rifles_(film)>	<Henry_King_(director)>
<Knock_Off_(film)>	<Tsui_Hark>
<Komodo_(film)>	<Michael_Lantieri>
<Komodo_vs._Cobra>	<Jim_Wynorski>
<Konga_Yo>	<Yves_Allégret>
<KT_(film)>	<Junji_Sakamoto>
<Kung_Fu_Hustle>	<Stephen_Chow>
<Kuroneko>	<Kaneto_Shindo>
<Lady_Frankenstein>	<Mel_Welles>
<Lady_Snowblood_(film)>	<Toshiya_Fujita_(director)>
<Laid_to_Rest_(film)>	<Robert_Green_Hall>
<Lake_Mungo_(film)>	<Joel_Anderson>
<Larva_(film)>	<Tim_Cox>
<Last_Ghost_Standing>	<Billy_Chung>
<Las_Aventuras_de_Pikín>	<Alberto_Abdala>
<Laws_of_Gravity_(film)>	<Nick_Gomez>
<La_Bestia_y_la_Espada_Magica>	<Paul_Naschy>
<La_Maldicion_de_la_Bestia>	<Miguel_Iglesias>
<La_Morte_Vivante>	<Jean_Rollin>
<La_steppa>	<Alberto_Lattuada>
<La_Tour,_prends_garde_!>	<Georges_Lampin>
<Legacy_of_Rage>	<Ronny_Yu>
<Legendary_Amazons>	<Frankie_Chan>
<Legend_of_the_Lost>	<Henry_Hathaway>
<Legend_of_the_Werewolf>	<Freddie_Francis>
<Legend_of_the_Wolf>	<Donnie_Yen>
<Legion_of_the_Night>	<Matt_Jaissle>
<Leoni_Leo>	<Alfréd_Deésy>
<Les_Tontons_flingueurs>	<Georges_Lautner>
<Let's_Kill_Uncle>	<William_Castle>
<Let's_Scare_Jessica_to_Death>	<John_D._Hancock>
<Lethal_Weapon>	<Richard_Donner>
<Let_Sleeping_Corpses_Lie_(film)>	<Jorge_Grau>
<Le_Masque_de_fer>	<Henri_Decoin>
<Lifepod>	<Ron_Silver>
<Lightning_Bug_(film)>	<Robert_Green_Hall>
<Lilo_&_Stitch>	<Dean_DeBlois>
<Lilo_&_Stitch>	<Chris_Sanders_(director)>
<Little_Shop_of_Horrors_(film)>	<Frank_Oz>
<Little_Treasure>	<Alan_Sharp>
<Live_Evil_(film)>	<Jay_Woelfel>
<Live_Free_or_Die_Hard>	<Len_Wiseman>
<Living_Hell_(film)>	<Richard_Jefferies_(screenwriter)>
<Long_Time_Dead>	<Marcus_Adams>
<Look_What's_Happened_to_Rosemary's_Baby>	<Sam_O'Steen>
<Looper_(film)>	<Rian_Johnson>
<Lootere>	<Dharmesh_Darshan>
<Lord_of_Illusions>	<Clive_Barker>
<Los_Amantes_del_Señor_de_la_Noche>	<Isela_Vega>
<Los_Bandoleros_(film)>	<Vin_Diesel>
<Lovely_But_Deadly>	<David_Sheldon>
<Love_Exposure>	<Sion_Sono>
<Luminous_Moss_(film)>	<Kei_Kumai>
<Lure_of_the_Circus>	<J._P._McGowan>
<Lure_of_the_Wilderness>	<Jean_Negulesco>
<Lust_for_a_Vampire>	<Jimmy_Sangster>
<Machine_Gun_McCain>	<Giuliano_Montaldo>
<Machine_Gun_Preacher>	<Marc_Forster>
<Macon_County_Line>	<Richard_Compton>
<Mad_Max_Beyond_Thunderdome>	<George_Miller_(filmmaker)>
<Mad_Max_Beyond_Thunderdome>	<George_Ogilvie>
<Mafia_(film)>	<Aziz_Sejawal>
<Mag-ingat_Ka_Sa..._Kulam>	<Jun_Lana>
<Magma_Head>	<Worm_Miller>
<Malaga_(film)>	<Richard_Sale_(director)>
<Malibu_Express>	<Andy_Sidaris>
<Malpertuis_(film)>	<Harry_Kümel>
<Manhattan_Baby>	<Lucio_Fulci>
<Mankatha>	<Venkat_Prabhu>
<Man_from_Cocody>	<Christian-Jaque>
<Man_Made_Monster>	<George_Waggner>
<Mark_of_the_Devil>	<Michael_Armstrong_(cinematographer)>
<Mark_of_the_Devil_Part_II>	<Adrian_Hoven>
<Mark_of_the_Vampire>	<Tod_Browning>
<Marooned_(film)>	<John_Sturges>
<Mars_Attacks!>	<Tim_Burton>
<Martial_Outlaw>	<Kurt_Andersen>
<Martin_(film)>	<George_A._Romero>
<Martyrs_(film)>	<Pascal_Laugier>
<Mary_Reilly_(film)>	<Stephen_Frears>
<Massacre_at_Central_High>	<Rene_Daalder>
<Masterminds_(film)>	<Roger_Christian_(filmmaker)>
<Master_Stroke>	<Michele_Lupo>
<Matango>	<Ishir?_Honda>
<May_(film)>	<Lucky_McKee>
<McBain_(film)>	<James_Glickenhaus>
<Mega_Snake>	<Tibor_Takács_(director)>
<Men_in_Black_(film)>	<Barry_Sonnenfeld>
<Messiah_of_Evil>	<Willard_Huyck>
<Messiah_of_Evil>	<Gloria_Katz>
<Metropolis_(film)>	<Fritz_Lang>
<Miami_Blues>	<George_Armitage>
<Miami_Supercops>	<Bruno_Corbucci>
<Ming_Ming>	<Susie_Au>
<Minutemen_(film)>	<Lev_L._Spiro>
<Miracle_of_the_White_Stallions>	<Arthur_Hiller>
<MirrorMask>	<Dave_McKean>
<Mirrors_(film)>	<Alexandre_Aja>
<Missing_Link_(film)>	<Carol_Hughes>
<Mission_to_Mars>	<Brian_De_Palma>
<Mister_Moses>	<Ronald_Neame>
<Mitchell_(film)>	<Andrew_McLaglen>
<Modern_Vampires>	<Richard_Elfman>
<Monster_Dog>	<Claudio_Fragasso>
<Monster_on_the_Campus>	<Jack_Arnold_(director)>
<Moon_of_the_Wolf>	<Daniel_Petrie>
<Mr._Magoo_(film)>	<Stanley_Tong>
<Mr._Sardonicus>	<William_Castle>
<Munchies_(film)>	<Tina_Hirsch>
<Muni_(film)>	<Raghava_Lawrence>
<Muppets_from_Space>	<Tim_Hill>
<Muppet_Treasure_Island>	<Brian_Henson>
<Murder-Set-Pieces>	<Nick_Palumbo>
<Murders_in_the_Zoo>	<A._Edward_Sutherland>
<Murder_Over_New_York>	<Harry_Lachman>
<My_Boyfriend's_Back_(film)>	<Bob_Balaban>
<My_Brother_the_Pig>	<Erik_Fleming_(director)>
<My_Left_Eye_Sees_Ghosts>	<Wai_Ka-Fai>
<My_Left_Eye_Sees_Ghosts>	<Johnnie_To>
<My_Little_Eye>	<Marc_Evans>
<My_Name_Is_Bruce>	<Bruce_Campbell>
<My_Soul_to_Take>	<Wes_Craven>
<Naan_Aval_Adhu>	<Kona_Venkat>
<Nagavalli_(film)>	<P._Vasu>
<Nang_Nak>	<Nonzee_Nimibutr>
<Nan_of_the_North>	<Duke_Worne>
<Nariman_(film)>	<K._Madhu>
<Nazis_at_the_Center_of_the_Earth>	<Joseph_Lawson>
<Near_Dark>	<Kathryn_Bigelow>
<Neelagiri_(film)>	<I._V._Sasi>
<Netherworld_(film)>	<David_Schmoeller>
<Nightbeast>	<Don_Dohler>
<Nightbreed>	<Clive_Barker>
<Nightmare_Beach>	<Umberto_Lenzi>
<Nightmare_Castle>	<Mario_Caiano>
<Nightmare_Circus_(film)>	<Alan_Rudolph>
<Nightmare_Detective>	<Shinya_Tsukamoto>
<Nightwing_(film)>	<Arthur_Hiller>
<Night_Life_(film)>	<David_Acomba>
<Night_of_Dark_Shadows>	<Dan_Curtis>
<Night_of_the_Creeps>	<Fred_Dekker>
<Night_of_the_Demon>	<Jacques_Tourneur>
<Night_of_the_Eagle>	<Sidney_Hayers>
<Night_of_the_Ghouls>	<Ed_Wood>
<Night_of_the_Juggler>	<Robert_Butler_(director)>
<Night_of_the_Living_Dead>	<George_A._Romero>
<Night_of_the_Seagulls>	<Amando_de_Ossorio>
<Night_Slaves>	<Ted_Post>
<Night_Train_to_Terror>	<Tom_McGowan>
<Nikos_the_Impaler>	<Andreas_Schnaas>
<Nim's_Island>	<Mark_Levin_(director)>
<Nim's_Island>	<Jennifer_Flackett>
<Ninja_(film)>	<Isaac_Florentine>
<Nitro_(film)>	<Alain_Desrochers>
<Noriko's_Dinner_Table>	<Sion_Sono>
<Northwest_Passage_(film)>	<King_Vidor>
<Nothing_But_the_Night>	<Peter_Sasdy>
<No_Deposit,_No_Return>	<Norman_Tokar>
<No_Retreat,_No_Surrender>	<Corey_Yuen>
<October_Moon>	<Jason_Paul_Collum>
<Office_Killer>	<Cindy_Sherman>
<Oldboy>	<Park_Chan-wook>
<Old_Gringo>	<Luis_Puenzo>
<Omega_Doom>	<Albert_Pyun>
<Omkara_(film)>	<Vishal_Bhardwaj>
<One_Armed_Boxer>	<Jimmy_Wang_(actor)>
<One_Body_Too_Many>	<Frank_McDonald_(director)>
<Onibaba_(film)>	<Kaneto_Shindo>
<On_the_Silver_Globe_(film)>	<Andrzej_?u?awski>
<Opera_(film)>	<Dario_Argento>
<Organ_(film)>	<Kei_Fujiwara>
<Orgy_of_the_Dead>	<Stephen_C._Apostolof>
<Orkkapurathu>	<Kamal_(director)>
<Osthe>	<S._Dharani>
<Otto;_or_Up_with_Dead_People>	<Bruce_LaBruce>
<Outbreak_(film)>	<Wolfgang_Petersen>
<Outland_(film)>	<Peter_Hyams>
<Over_the_Hedge_(film)>	<Karey_Kirkpatrick>
<Over_the_Hedge_(film)>	<Tim_Johnson_(film_director)>
<O_Brother,_Where_Art_Thou?>	<Coen_brothers>
<Pachhadlela>	<Mahesh_Kothare>
<Paiyaa>	<N._Linguswamy>
<Panic_Beats>	<Paul_Naschy>
<Panjaa>	<Vishnuvardhan_(director)>
<Paperhouse_(film)>	<Bernard_Rose_(director)>
<Parama_Veera_Chakra>	<Dasari_Narayana_Rao>
<Paranoiac_(film)>	<Freddie_Francis>
<Paranormal_Activity>	<Oren_Peli>
<Parasomnia_(film)>	<William_Malone_(director)>
<Parents_(film)>	<Bob_Balaban>
<Patient_X_(film)>	<Yam_Laranas>
<Paul_(film)>	<Greg_Mottola>
<Perfect_Creature>	<Glenn_Standring>
<Pervirella>	<Alex_Chandon>
<Pet_Sematary_Two>	<Mary_Lambert>
<Phantasm_(film)>	<Don_Coscarelli>
<Phantoms_(film)>	<Joe_Chappelle>
<Phobia_(film)>	<John_Huston>
<Pineapple_Express_(film)>	<David_Gordon_Green>
<Pinocchio's_Revenge>	<Kevin_S._Tenney>
<Pinocchio_in_Outer_Space>	<Ray_Goossens>
<Pirates_of_the_High_Seas>	<Spencer_Gordon_Bennet>
<Pirates_of_the_High_Seas>	<Thomas_Carr_(director)>
<Pitch_Black_(film)>	<David_Twohy>
<Plaga_Zombie>	<Pablo_Parés>
<Plaguers>	<Brad_Sykes>
<Planet_of_Dinosaurs>	<James_Shea>
<Pokkiri>	<Prabhu_Deva>
<Poltergeist_III>	<Gary_Sherman_(director)>
<Pontiac_Moon>	<Peter_Medak>
<Pontianak_Harum_Sundal_Malam>	<Shuhaimi_Baba>
<Poongsan>	<Juhn_Jai-hong>
<Porco_Rosso>	<Hayao_Miyazaki>
<Postal_(film)>	<Uwe_Boll>
<Praja>	<Joshiy>
<Prankstar>	<Tom_Green>
<Prasthanam>	<Deva_Katta>
<Premium_Rush>	<David_Koepp>
<Progeny_(film)>	<Brian_Yuzna>
<Project_A>	<Jackie_Chan>
<Prophecies_of_Nostradamus>	<Toshio_Masuda>
<Prophecy_(film)>	<John_Frankenheimer>
<Psychomania>	<Don_Sharp>
<Psychosis_(film)>	<Reg_Traviss>
<Psycho_Cop>	<Wallace_Potts>
<Psycho_III>	<Anthony_Perkins>
<Psycho_II_(film)>	<Richard_Franklin_(director)>
<Public_Enemy_Returns>	<Kang_Woo-suk>
<Pudhupettai>	<Selvaraghavan>
<Pumpkinhead_(film)>	<Stan_Winston>
<Puppet_Master_(film)>	<David_Schmoeller>
<Puppet_Master_vs_Demonic_Toys>	<Ted_Nicolaou>
<Purana_Mandir>	<Tulsi_Ramsay>
<Purana_Mandir>	<Shyam_Ramsay>
<Quarantine_(film)>	<John_Erick_Dowdle>
<Queen_of_Blood>	<Curtis_Harrington>
<Queen_of_Outer_Space>	<Edward_Bernds>
<Queen_of_the_Damned_(film)>	<Michael_Rymer>
<Quest_for_Fire_(film)>	<Jean-Jacques_Annaud>
<Quicksilver_Highway>	<Mick_Garris>
<Q_(film)>	<Larry_Cohen>
<Raat_(film)>	<Ram_Gopal_Varma>
<Rabid>	<David_Cronenberg>
<Radioactive_Dreams>	<Albert_Pyun>
<Raffles,_the_Amateur_Cracksman>	<George_Irving_(American_actor)>
<Rahtree_Reborn>	<Yuthlert_Sippapak>
<Raising_Cain>	<Brian_De_Palma>
<Rajavazhcha>	<J._Sasikumar>
<Rakht>	<Mahesh_Manjrekar>
<Rambo_(film)>	<Sylvester_Stallone>
<Ratman>	<Giuliano_Carnimeo>
<Rat_Race_(film)>	<Jerry_Zucker_(film_director)>
<Rat_Trap_(film)>	<Jean-Gabriel_Albicocco>
<Rawhead_Rex_(film)>	<George_Pavlou>
<Razor_Blade_Smile>	<Jake_West>
<Re-cycle>	<Pang_brothers>
<REC_(film)>	<Paco_Plaza>
<REC_(film)>	<Jaume_Balagueró>
<Red_Rose_(film)>	<P._Bharathiraja>
<Reincarnation_(film)>	<Takashi_Shimizu>
<Reindeer_Games>	<John_Frankenheimer>
<Repati_Pourulu>	<T._Krishna>
<Repossessed_(film)>	<Bob_Logan_(film_director)>
<Reptilicus>	<Poul_Bang>
<Reptilicus>	<Sidney_W._Pink>
<Rest_Stop_(film)>	<John_Shiban>
<Retro_Puppet_Master>	<David_DeCoteau>
<Return_from_Witch_Mountain>	<John_Hough_(director)>
<Return_of_the_Blind_Dead>	<Amando_de_Ossorio>
<Return_of_the_Fly>	<Edward_Bernds>
<Return_of_the_Living_Dead_Part_II>	<Ken_Wiederhorn>
<Return_to_Oz>	<Walter_Murch>
<Return_to_Sleepaway_Camp>	<Robert_Hiltzik>
<Revenge_of_the_Creature>	<Jack_Arnold_(director)>
<Revolt_of_the_Zombies>	<Victor_Hugo_Halperin>
<Reykjavik_Whale_Watching_Massacre>	<Júlíus_Kemp>
<Richie_Rich_(film)>	<Donald_Petrie>
<Riddick_(film)>	<David_Twohy>
<Riders_to_the_Stars>	<Richard_Carlson>
<Riders_to_the_Stars>	<Herbert_L._Strock>
<Riding_the_Bullet_(film)>	<Mick_Garris>
<Righteous_Ties>	<Jang_Jin>
<Righting_Wrongs>	<Tsui_Hark>
<Righting_Wrongs>	<Yuen_Biao>
<Righting_Wrongs>	<Corey_Yuen>
<Ring_(film)>	<Hideo_Nakata>
<Ring_of_Darkness>	<David_DeCoteau>
<Rising_Sun_(film)>	<Philip_Kaufman>
<River_Lady_(film)>	<George_Sherman>
<Road_to_Morocco>	<David_Butler_(director)>
<Road_to_Zanzibar>	<Victor_Schertzinger>
<Robinson_Crusoe_on_Mars>	<Byron_Haskin>
<Robots_(film)>	<Chris_Wedge>
<Robots_(film)>	<Carlos_Saldanha>
<Robot_Wars_(film)>	<Albert_Band>
<Rob_Roy,_the_Highland_Rogue>	<Harold_French>
<RocknRolla>	<Guy_Ritchie>
<Rock_Monster>	<Declan_O'Brien>
<Rodan_(film)>	<Ishir?_Honda>
<Rogue_(film)>	<Greg_McLean>
<Rosemary's_Baby_(film)>	<Roman_Polanski>
<Royal_Flash_(film)>	<Richard_Lester>
<Royal_Kill>	<Babar_Ahmed>
<Rrugicat_që_kërkonin_diell>	<Saimir_Kumbaro>
<Running_on_Karma>	<Johnnie_To>
<Running_on_Karma>	<Wai_Ka-Fai>
<Run_Lola_Run>	<Tom_Tykwer>
<S.O.S._Noronha>	<Georges_Rouquier>
<Saint_Ange>	<Pascal_Laugier>
<Salween_(film)>	<Chatrichalerm_Yukol>
<Sandakozhi>	<N._Linguswamy>
<Sanders_of_the_River>	<Zoltan_Korda>
<Santa_Claws>	<John_A._Russo>
<Santa_Sangre>	<Alejandro_Jodorowsky>
<Santo_Contra_los_Zombis>	<Benito_Alazraki>
<Santo_vs._las_Mujeres_Vampiro>	<Alfonso_Corona_Blake>
<Satan's_Baby_Doll>	<Mario_Bianchi>
<Satan's_Cheerleaders>	<Greydon_Clark>
<Satan's_Little_Helper>	<Jeff_Lieberman>
<Satan's_Playground>	<Dante_Tomaselli>
<Satan's_Slave>	<Norman_J._Warren>
<Satanic_(film)>	<Daniel_Golden>
<Satan_Hates_You>	<James_Felix_McKenney>
<Savage_Weekend>	<David_Paulsen>
<Saviour_of_the_Soul>	<Corey_Yuen>
<Saviour_of_the_Soul>	<Jeffrey_Lau>
<Sayonara_Jupiter_(film)>	<Koji_Hashimoto_(director)>
<Scanner_Cop>	<Pierre_David>
<Scared_(film)>	<Pakphum_Wonjinda>
<Scars_of_Dracula>	<Roy_Ward_Baker>
<Schlock_(film)>	<John_Landis>
<Scooby-Doo_(film)>	<Raja_Gosnell>
<Scott_Pilgrim_vs._the_World>	<Edgar_Wright>
<Scream_(film)>	<Wes_Craven>
<Scream_of_the_Wolf>	<Dan_Curtis>
<Second_Time_Around_(film)>	<Jeffrey_Lau>
<Secret_Window>	<David_Koepp>
<Seed_of_Chucky>	<Don_Mancini>
<See_No_Evil_(film)>	<Gregory_Dark>
<Sehar>	<Kabeer_Kaushik>
<Seizure_(film)>	<Oliver_Stone>
<Sengoku_Yaro>	<Kihachi_Okamoto>
<Sept_hommes_et_une_garce>	<Bernard_Borderie>
<Sesame_Street_Presents_Follow_That_Bird>	<Ken_Kwapis>
<Seven_(film)>	<David_Fincher>
<Seven_Cities_of_Gold_(film)>	<Robert_D._Webb>
<Shadowzone_(film)>	<J._S._Cardone>
<Shadow_Builder>	<Jamie_Dixon>
<Shadow_of_the_Vampire>	<E._Elias_Merhige>
<Shanks_(film)>	<William_Castle>
<Shaolin_Soccer>	<Stephen_Chow>
<Shaun_of_the_Dead>	<Edgar_Wright>
<Shéhérazade_(film)>	<Pierre_Gaspard-Huit>
<She_Killed_in_Ecstasy>	<Jesús_Franco>
<Shivers_(film)>	<David_Cronenberg>
<Shocker_(film)>	<Wes_Craven>
<Shock_Waves_(film)>	<Ken_Wiederhorn>
<Shootout_at_Wadala>	<Sanjay_Gupta_(director)>
<Shrek>	<Vicky_Jenson>
<Shrek>	<Andrew_Adamson>
<Shrek_the_Third>	<Chris_Miller_(animator)>
<Shrek_the_Third>	<Raman_Hui>
<Shrieker_(film)>	<David_DeCoteau>
<Shrunken_Heads_(film)>	<Richard_Elfman>
<Silent_Hill_(film)>	<Christophe_Gans>
<Silent_Running>	<Douglas_Trumbull>
<Silver_Bullet_(film)>	<Dan_Attias>
<Simon_Says_(film)>	<William_Dear>
<Singam>	<Hari_(director)>
<Singoalla_(film)>	<Christian-Jaque>
<Skull_Heads>	<Charles_Band>
<Slattery's_Hurricane>	<André_de_Toth>
<Slaughter_High>	<Peter_Litten>
<Slayers_Gorgeous>	<Hiroshi_Watanabe_(animator)>
<Sleepwalkers_(film)>	<Mick_Garris>
<Smokin'_Aces>	<Joe_Carnahan>
<Snow_Dogs>	<Brian_Levant>
<Sodoma's_Ghost>	<Lucio_Fulci>
<Solar_Crisis_(film)>	<Richard_C._Sarafian>
<Solstice_(film)>	<Daniel_Myrick>
<Something_Beneath_(film)>	<David_Winning>
<Something_Wicked_This_Way_Comes_(film)>	<Jack_Clayton>
<Sometimes_They_Come_Back..._Again>	<Adam_Grossman>
<Sometimes_They_Come_Back_(film)>	<Tom_McLoughlin>
<Sonatine>	<Takeshi_Kitano>
<Son_of_Frankenstein>	<Rowland_V._Lee>
<Son_of_Godzilla>	<Jun_Fukuda>
<Sorority_House_Massacre_II>	<Jim_Wynorski>
<Sorority_Row>	<Stewart_Hendler>
<Souls_at_Sea>	<Henry_Hathaway>
<So_Undercover>	<Tom_Vaughan_(director)>
<Spaceballs>	<Mel_Brooks>
<Space_Chimps>	<Kirk_DeMicco>
<Space_Jam>	<Joe_Pytka>
<Space_Men>	<Antonio_Margheriti>
<Spasms>	<William_Fruet>
<Spawn_of_the_North>	<Henry_Hathaway>
<Species_II>	<Peter_Medak>
<Speed_Angels>	<Jingle_Ma>
<Speed_Demon_(film)>	<David_DeCoteau>
<Speed_Racer_(film)>	<The_Wachowskis>
<Spirited_Away>	<Hayao_Miyazaki>
<Splatter_Farm>	<Polonia_brothers>
<Spy_Game>	<Tony_Scott>
<Squirm_(film)>	<Jeff_Lieberman>
<Stander_(film)>	<Bronwen_Hughes>
<Star_Kid>	<Manny_Coto>
<Stephen_King's_Desperation_(film)>	<Mick_Garris>
<Sthalathe_Pradhana_Payyans>	<Shaji_Kailas>
<Stir_of_Echoes>	<David_Koepp>
<Stopover_Tokyo>	<Richard_L._Breen>
<Storm_Over_the_Nile>	<Zoltan_Korda>
<Storm_Over_the_Nile>	<Terence_Young_(director)>
<Stranger_in_Our_House>	<Wes_Craven>
<Strange_Behavior>	<Michael_Laughlin>
<Strange_Days_(film)>	<Kathryn_Bigelow>
<Strange_Wilderness>	<Fred_Wolf>
<Strangler_vs._Strangler>	<Slobodan_Šijan>
<Street_Trash>	<J._Michael_Muro>
<Striking_Distance>	<Rowdy_Herrington>
<Submarine_Attack>	<Duilio_Coletti>
<Suburban_Commando>	<Burt_Kennedy>
<Super_Fly_T.N.T.>	<Ron_O'Neal>
<Surrogates_(film)>	<Jonathan_Mostow>
<Sur_la_piste_du_Marsupilami>	<Alain_Chabat>
<Suspiria>	<Dario_Argento>
<Swamp_Devil>	<David_Winning>
<Sweet_Kill>	<Curtis_Hanson>
<Sympathy_for_Mr._Vengeance>	<Park_Chan-wook>
<Taaqatwar>	<David_Dhawan>
<Tactical_Force>	<Adamo_Paolo_Cultraro>
<Tagget>	<Richard_T._Heffron>
<Taken_(film)>	<Pierre_Morel>
<Tales_from_the_Hood>	<Rusty_Cundieff>
<Tales_of_Terror>	<Roger_Corman>
<Tall_Tale_(film)>	<Jeremiah_S._Chechik>
<Tam-Lin_(film)>	<Roddy_McDowall>
<Tanganyika_(film)>	<André_de_Toth>
<Tarantula_(film)>	<Jack_Arnold_(director)>
<Tarzan's_Fight_for_Life>	<H._Bruce_Humberstone>
<Taste_the_Blood_of_Dracula>	<Peter_Sasdy>
<Taxandria_(film)>	<Raoul_Servais>
<Teeth_(film)>	<Mitchell_Lichtenstein>
<Tenebrae_(film)>	<Dario_Argento>
<Ten_Tall_Men>	<Willis_Goldbeck>
<Terminal_Velocity_(film)>	<Deran_Sarafian>
<TerrorVision>	<Ted_Nicolaou>
<Terror_Firmer>	<Lloyd_Kaufman>
<Thaamirabharani>	<Hari_(director)>
<Thalastaanam>	<Shaji_Kailas>
<Theatre_of_Blood>	<Douglas_Hickox>
<Them!>	<Gordon_Douglas_(director)>
<Thenkasipattanam>	<Rafi_Mecartin>
<They_Have_Changed_Their_Face>	<Corrado_Farina>
<They_Nest_(film)>	<Ellory_Elkayem>
<They_Wait>	<Ernie_Barbarash>
<The_'Burbs>	<Joe_Dante>
<The_Abominable_Dr._Phibes>	<Robert_Fuest>
<The_Adventures_of_Arsène_Lupin>	<Jacques_Becker>
<The_Adventures_of_Elmo_in_Grouchland>	<Gary_Halvorson>
<The_Adventures_of_Fra_Diavolo>	<Luigi_Zampa>
<The_Adventures_of_Marco_Polo>	<John_Ford>
<The_Adventures_of_Marco_Polo>	<Archie_Mayo>
<The_Alligator_People>	<Roy_Del_Ruth>
<The_Ape>	<William_Nigh>
<The_Ape_Man>	<William_Beaudine>
<The_Arrival_(film)>	<David_Twohy>
<The_Astro-Zombies>	<Ted_V._Mikels>
<The_Astronaut's_Wife>	<Rand_Ravich>
<The_Awful_Dr._Orloff>	<Jesús_Franco>
<The_Barrier_(film)>	<George_W._Hill>
<The_Bar_at_the_Crossing>	<Alain_Levent>
<The_Bat_Whispers>	<Roland_West>
<The_Beach_(film)>	<Danny_Boyle>
<The_Beast_in_the_Cellar>	<James_Kelley>
<The_Beast_of_Yucca_Flats>	<Coleman_Francis>
<The_Beast_with_Five_Fingers>	<Robert_Florey>
<The_Believers>	<John_Schlesinger>
<The_Bird_with_the_Crystal_Plumage>	<Dario_Argento>
<The_Black_Scorpion_(film)>	<Edward_Ludwig>
<The_Black_Secret>	<George_B._Seitz>
<The_Black_Shield_of_Falworth>	<Rudolph_Maté>
<The_Black_Sleep>	<Reginald_Le_Borg>
<The_Black_Stallion_Returns>	<Robert_Dalva>
<The_Black_Torment>	<Robert_Hartford-Davis>
<The_Blade_(film)>	<Tsui_Hark>
<The_Blair_Witch_Project>	<Eduardo_Sánchez_(director)>
<The_Blair_Witch_Project>	<Daniel_Myrick>
<The_Blob>	<Irvin_Yeaworth>
<The_Blonde_from_Singapore>	<Edward_Dmytryk>
<The_Bloody_Exorcism_of_Coffin_Joe>	<José_Mojica_Marins>
<The_Blood_Bond>	<Bey_Logan>
<The_Blood_Bond>	<Michael_Biehn>
<The_Blood_Spattered_Bride>	<Vicente_Aranda>
<The_Blue_Butterfly_(film)>	<Léa_Pool>
<The_Blue_Fox>	<Duke_Worne>
<The_Body_Snatcher_(film)>	<Robert_Wise>
<The_Boogie_Man_Will_Get_You>	<Lew_Landers>
<The_Boondock_Saints>	<Troy_Duffy>
<The_Brass_Bullet>	<Ben_F._Wilson>
<The_Brave_Little_Toaster_(film)>	<Jerry_Rees>
<The_Brides_of_Dracula>	<Terence_Fisher>
<The_Brides_of_Fu_Manchu>	<Don_Sharp>
<The_Bride_(film)>	<Franc_Roddam>
<The_Brigand>	<Phil_Karlson>
<The_Brink's_Job>	<William_Friedkin>
<The_Broken_(film)>	<Sean_Ellis>
<The_Broken_Coin>	<Francis_Ford_(actor)>
<The_Brood>	<David_Cronenberg>
<The_Brotherhood_II>	<David_DeCoteau>
<The_Burning_(film)>	<Tony_Maylam>
<The_Business_(film)>	<Nick_Love>
<The_Cabinet_of_Dr._Caligari>	<Robert_Wiene>
<The_Cabin_in_the_Woods>	<Drew_Goddard>
<The_Camels_are_Coming_(film)>	<Tim_Whelan>
<The_Cannibal_Man>	<Eloy_de_la_Iglesia>
<The_Card_Player>	<Dario_Argento>
<The_Castle_of_the_Monsters>	<Julián_Soler>
<The_Cell>	<Tarsem_Singh>
<The_Cellar_(film)>	<Kevin_S._Tenney>
<The_Changeling_(film)>	<Peter_Medak>
<The_Child's_Eye>	<Pang_brothers>
<The_Chipmunk_Adventure>	<Janice_Karman>
<The_Church_(film)>	<Michele_Soavi>
<The_City_of_the_Dead_(film)>	<John_Llewellyn_Moxey>
<The_Climax>	<George_Waggner>
<The_Clown_Murders>	<Martyn_Burke>
<The_Colossus_of_New_York>	<Eugène_Lourié>
<The_Colossus_of_Rhodes_(film)>	<Sergio_Leone>
<The_Comedy_of_Terrors>	<Jacques_Tourneur>
<The_Company_of_Wolves>	<Neil_Jordan>
<The_Corpse_Vanishes>	<Wallace_Fox>
<The_Cottage_(film)>	<Paul_Andrew_Williams>
<The_Craft_(film)>	<Andrew_Fleming>
<The_Crawling_Hand>	<Herbert_L._Strock>
<The_Cremator>	<Juraj_Herz>
<The_Crimson_Stain_Mystery>	<T._Hayes_Hunter>
<The_Croods>	<Kirk_DeMicco>
<The_Croods>	<Chris_Sanders_(director)>
<The_Curse_of_Frankenstein>	<Terence_Fisher>
<The_Curse_of_the_Living_Corpse>	<Del_Tenney>
<The_Curse_of_the_Werewolf>	<Terence_Fisher>
<The_Dark_Crystal>	<Jim_Henson>
<The_Dark_Crystal>	<Frank_Oz>
<The_Dark_Eyes_of_London_(film)>	<Walter_Summers>
<The_Darwin_Awards_(film)>	<Finn_Taylor>
<The_Day_of_the_Triffids_(film)>	<Steve_Sekely>
<The_Deadly_Bees>	<Freddie_Francis>
<The_Dead_Zone_(film)>	<David_Cronenberg>
<The_Devil's_Backbone>	<Guillermo_del_Toro>
<The_Devil's_Rain>	<Robert_Fuest>
<The_Devil's_Rejects>	<Rob_Zombie>
<The_Devil-Doll>	<Tod_Browning>
<The_Devils_(film)>	<Ken_Russell>
<The_Devil_Commands>	<Edward_Dmytryk>
<The_Devil_Rides_Out_(film)>	<Terence_Fisher>
<The_Diamond_from_the_Sky>	<William_Desmond_Taylor>
<The_Diamond_from_the_Sky>	<Jacques_Jaccard>
<The_Dirty_Dozen>	<Robert_Aldrich>
<The_Dive>	<Tristan_DeVere_Cole>
<The_Electric_Horseman>	<Sydney_Pollack>
<The_Emerald_Forest>	<John_Boorman>
<The_Exorcism_of_Emily_Rose>	<Scott_Derrickson>
<The_Exorcist_III>	<William_Peter_Blatty>
<The_Eye_Creatures>	<Larry_Buchanan>
<The_Fabulous_World_of_Jules_Verne>	<Karel_Zeman>
<The_Fearless_Vampire_Killers>	<Roman_Polanski>
<The_Final_Destination>	<David_R._Ellis>
<The_Final_Terror>	<Andrew_Davis_(film_director)>
<The_First_Deadly_Sin>	<Brian_G._Hutton>
<The_Flight_of_Dragons>	<Katsuhisa_Yamada>
<The_Flight_of_Dragons>	<Jules_Bass>
<The_Flight_of_Dragons>	<Arthur_Rankin,_Jr.>
<The_Flintstones_(film)>	<Brian_Levant>
<The_Forsaken_(film)>	<J._S._Cardone>
<The_Fortieth_Door>	<George_B._Seitz>
<The_Fourth_Man>	<Paul_Verhoeven>
<The_French_Connection_(film)>	<William_Friedkin>
<The_Frighteners>	<Peter_Jackson>
<The_Funhouse>	<Tobe_Hooper>
<The_Garbage_Pail_Kids_Movie>	<Rod_Amateau>
<The_Gate_(film)>	<Tibor_Takács_(director)>
<The_Gene_Generation>	<Pearry_Teo>
<The_Ghost_Breakers>	<George_Marshall_(director)>
<The_Ghost_Galleon>	<Amando_de_Ossorio>
<The_Ghost_of_Frankenstein>	<Erle_C._Kenton>
<The_Ghouls>	<Chad_Ferrin>
<The_Giant_Claw>	<Fred_F._Sears>
<The_Gingerdead_Man>	<Charles_Band>
<The_Gorgon>	<Terence_Fisher>
<The_Graduates_of_Malibu_High>	<Lawrence_D._Foldes>
<The_Graves_(film)>	<Brian_Pulido>
<The_Great_Circus_Mystery>	<Jay_Marchant>
<The_Grey>	<Joe_Carnahan>
<The_Grim_Game>	<Irvin_Willat>
<The_Grissom_Gang>	<Robert_Aldrich>
<The_Grudge>	<Takashi_Shimizu>
<The_Hamiltons>	<Butcher_brothers>
<The_Hand_(film)>	<Oliver_Stone>
<The_Hard_Corps>	<Sheldon_Lettich>
<The_Haunted_Palace>	<Roger_Corman>
<The_Haunting_in_Connecticut>	<Peter_Cornwell>
<The_Hawk's_Nest_(film)>	<Benjamin_Christensen>
<The_Hidden_(film)>	<Jack_Sholder>
<The_Hideous_Sun_Demon>	<Robert_Clarke>
<The_Hills_Have_Eyes_Part_II>	<Wes_Craven>
<The_Hitchhiker_(film)>	<Leigh_Scott>
<The_Horror_of_Frankenstein>	<Jimmy_Sangster>
<The_House_Next_Door_(film)>	<Jeff_Woolnough>
<The_House_of_Clocks>	<Lucio_Fulci>
<The_House_of_the_Devil>	<Ti_West>
<The_House_on_Sorority_Row>	<Mark_Rosman>
<The_House_on_the_Edge_of_the_Park>	<Ruggero_Deodato>
<The_House_That_Dripped_Blood>	<Peter_Duffell>
<The_House_with_Laughing_Windows>	<Pupi_Avati>
<The_Howling_(film)>	<Joe_Dante>
<The_Human_Centipede_(First_Sequence)>	<Tom_Six>
<The_Ice_Pirates>	<Stewart_Raffill>
<The_Imaginarium_of_Doctor_Parnassus>	<Terry_Gilliam>
<The_Impossible_Voyage>	<Georges_Méliès>
<The_Incredible_Shrinking_Man>	<Jack_Arnold_(director)>
<The_Innkeepers_(film)>	<Ti_West>
<The_Inn_on_the_River>	<Alfred_Vohrer>
<The_Invisible_Man's_Revenge>	<Ford_Beebe>
<The_Invisible_Man_Returns>	<Joe_May>
<The_Iron_Crown>	<Alessandro_Blasetti>
<The_Jack_of_Diamonds>	<Vernon_Sewell>
<The_Journey_of_Natty_Gann>	<Jeremy_Kagan>
<The_Journey_to_Melonia>	<Per_Åhlin>
<The_Karate_Kid,_Part_III>	<John_G._Avildsen>
<The_King_&_the_Commissioner>	<Shaji_Kailas>
<The_Kiss_of_the_Vampire>	<Don_Sharp>
<The_Lair_of_the_White_Worm_(film)>	<Ken_Russell>
<The_Lake_(film)>	<David_Jackson_(director)>
<The_Last_Horror_Film>	<David_Winters_(choreographer)>
<The_Last_Run>	<Richard_Fleischer>
<The_Last_Unicorn_(film)>	<Arthur_Rankin,_Jr.>
<The_Last_Unicorn_(film)>	<Jules_Bass>
<The_Legend_of_Hell_House>	<John_Hough_(director)>
<The_Legend_of_Lobo>	<James_Algar>
<The_Legend_of_Lobo>	<Jack_Couffer>
<The_Legend_of_Zu>	<Tsui_Hark>
<The_Leopard_Man>	<Jacques_Tourneur>
<The_Levenger_Tapes>	<Mark_Edwin_Robinson>
<The_Life_of_General_Villa>	<Christy_Cabanne>
<The_Limey>	<Steven_Soderbergh>
<The_Lion's_Claws>	<Jacques_Jaccard>
<The_Lion_King>	<Rob_Minkoff>
<The_Lion_King>	<Roger_Allers>
<The_Little_Dragons>	<Curtis_Hanson>
<The_Little_Girl_Who_Lives_Down_the_Lane>	<Nicolas_Gessner>
<The_Lords_of_Salem_(film)>	<Rob_Zombie>
<The_Lost_Boys>	<Joel_Schumacher>
<The_Mad_(film)>	<John_Kalangis>
<The_Mad_Magician>	<John_Brahm>
<The_Mad_Monster>	<Sam_Newfield>
<The_Magnetic_Monster>	<Herbert_L._Strock>
<The_Magnetic_Monster>	<Curt_Siodmak>
<The_Manitou>	<William_Girdler>
<The_Manster>	<George_Breakston>
<The_Man_Who_Changed_His_Mind>	<Robert_Stevenson_(director)>
<The_Man_Who_Could_Cheat_Death>	<Terence_Fisher>
<The_Man_with_Two_Brains>	<Carl_Reiner>
<The_Mask_of_Diijon>	<Lew_Landers>
<The_Mask_of_Fu_Manchu>	<Charles_Vidor>
<The_Mask_of_Fu_Manchu>	<Charles_Brabin>
<The_Masque_of_the_Red_Death_(film)>	<Roger_Corman>
<The_Mephisto_Waltz_(film)>	<Paul_Wendkos>
<The_Messengers_(film)>	<Pang_brothers>
<The_Million_Dollar_Mystery>	<Howell_Hansel>
<The_Mine_with_the_Iron_Door>	<Sam_Wood>
<The_Mole_People_(film)>	<Virgil_W._Vogel>
<The_Mollycoddle>	<Victor_Fleming>
<The_Monster_Club>	<Roy_Ward_Baker>
<The_Monster_Maker>	<Sam_Newfield>
<The_Monster_Walks>	<Frank_R._Strayer>
<The_Mother_of_Tears>	<Dario_Argento>
<The_Mummy's_Hand>	<Christy_Cabanne>
<The_Mysterians>	<Ishir?_Honda>
<The_Mystery_of_the_Third_Planet>	<Roman_Abelevich_Kachanov>
<The_Naked_Monster>	<Ted_Newsom>
<The_Navy_vs._the_Night_Monsters>	<Michael_A._Hoey>
<The_New_York_Ripper>	<Lucio_Fulci>
<The_Night_Evelyn_Came_Out_of_the_Grave>	<Emilio_Miraglia>
<The_Night_Stalker_(film)>	<John_Llewellyn_Moxey>
<The_Ninth_Configuration>	<William_Peter_Blatty>
<The_Oblong_Box_(film)>	<Gordon_Hessler>
<The_Off_Season>	<James_Felix_McKenney>
<The_Old_Dark_House>	<James_Whale>
<The_Omen>	<Richard_Donner>
<The_Osterman_Weekend_(film)>	<Sam_Peckinpah>
<The_Outside_Man>	<Jacques_Deray>
<The_Pacifier>	<Adam_Shankman>
<The_Peking_Medallion>	<Frank_Winterstein>
<The_People_That_Time_Forgot_(film)>	<Kevin_Connor_(director)>
<The_People_Under_the_Stairs>	<Wes_Craven>
<The_Phantom_Foe>	<Bertram_Millhauser>
<The_Phantom_Tollbooth_(film)>	<Chuck_Jones>
<The_Phantom_Tollbooth_(film)>	<Abe_Levitow>
<The_Philadelphia_Experiment_(film)>	<Stewart_Raffill>
<The_Plague_Dogs_(film)>	<Martin_Rosen_(director)>
<The_Poughkeepsie_Tapes>	<John_Erick_Dowdle>
<The_Premature_Burial_(film)>	<Roger_Corman>
<The_Princess_Blade>	<Shinsuke_Sato>
<The_Princess_Bride_(film)>	<Rob_Reiner>
<The_Prodigal_Son_(film)>	<Sammo_Hung>
<The_Projected_Man>	<Ian_Curteis>
<The_Prophecy>	<Gregory_Widen>
<The_Pumpkin_Karver>	<Robert_Mann>
<The_Radio_King>	<Robert_F._Hill>
<The_Rat_Savior>	<Krsto_Papi?>
<The_Reaping>	<Stephen_Hopkins_(director)>
<The_Red_Ace>	<Jacques_Jaccard>
<The_Red_Queen_Kills_Seven_Times>	<Emilio_Miraglia>
<The_Reflecting_Skin_(film)>	<Philip_Ridley>
<The_Return_of_the_Vampire>	<Lew_Landers>
<The_Revenge_of_Frankenstein>	<Terence_Fisher>
<The_Rifleman_of_the_Voroshilov_Regiment>	<Stanislav_Govorukhin>
<The_Rings>	<Mohammad-Reza_Honarmand>
<The_Ring_Two>	<Hideo_Nakata>
<The_Road_to_El_Dorado>	<Bibo_Bergeron>
<The_Robbers_(film)>	<Francisco_Rovira_Beleta>
<The_Rocky_Horror_Picture_Show>	<Jim_Sharman>
<The_Rock_(film)>	<Michael_Bay>
<The_Roller_Blade_Seven>	<Donald_G._Jackson>
<The_Romance_of_Tarzan>	<Wilfred_Lucas>
<The_Roost>	<Ti_West>
<The_Safecracker>	<Ray_Milland>
<The_Satanic_Rites_of_Dracula>	<Alan_Gibson_(director)>
<The_Satan_Bug>	<John_Sturges>
<The_Scarlet_Coat>	<John_Sturges>
<The_Screaming_Skull>	<Alex_Nicol>
<The_Sealed_Room>	<D._W._Griffith>
<The_Sea_Beast>	<Millard_Webb>
<The_Secret_of_Roan_Inish>	<John_Sayles>
<The_Seven-Ups>	<Philip_D'Antoni>
<The_Seventh_Curse>	<Lam_Ngai_Kai>
<The_Seventh_Sign>	<Carl_Schultz>
<The_Seventh_Victim>	<Mark_Robson>
<The_She_Beast>	<Michael_Reeves>
<The_Shining_(film)>	<Stanley_Kubrick>
<The_Shortcut>	<Nicholaus_Goossen>
<The_Shuttered_Room>	<David_Greene_(director)>
<The_Sicilian_(film)>	<Michael_Cimino>
<The_Silence_of_the_Lambs_(film)>	<Jonathan_Demme>
<The_Silent_Flyer>	<William_James_Craft>
<The_Sinister_Urge_(film)>	<Ed_Wood>
<The_Sixth_Sense>	<M._Night_Shyamalan>
<The_Skeptic_(film)>	<Tennyson_Bardwell>
<The_Skull>	<Freddie_Francis>
<The_Sky_Crawlers_(film)>	<Mamoru_Oshii>
<The_Smurfs_(film)>	<Raja_Gosnell>
<The_Soldier_(film)>	<James_Glickenhaus>
<The_Son_of_Robin_Hood>	<George_Sherman>
<The_Spanish_Main>	<Frank_Borzage>
<The_Spider's_Web>	<Ray_Taylor_(director)>
<The_Spider's_Web>	<James_W._Horne>
<The_Spider_Returns>	<James_W._Horne>
<The_Sting>	<George_Roy_Hill>
<The_Stone_Killer>	<Michael_Winner>
<The_Strange_Door>	<Joseph_Pevney>
<The_Strange_World_of_Planet_X_(film)>	<Gilbert_Gunn>
<The_Sum_of_All_Fears_(film)>	<Phil_Alden_Robinson>
<The_Taking_of_Beverly_Hills>	<Sidney_J._Furie>
<The_Terminal_Man_(film)>	<Mike_Hodges>
<The_Terminator>	<James_Cameron>
<The_Terrible_People>	<Spencer_Gordon_Bennet>
<The_Terror_Within_II>	<Andrew_Stevens>
<The_Testament_of_Dr._Mabuse>	<Fritz_Lang>
<The_Texas_Chain_Saw_Massacre>	<Tobe_Hooper>
<The_Theatre_Bizarre>	<Douglas_Buck>
<The_Theatre_Bizarre>	<Tom_Savini>
<The_Theatre_Bizarre>	<Karim_Hussain>
<The_Theatre_Bizarre>	<Richard_Stanley_(film_director)>
<The_Theatre_Bizarre>	<Buddy_Giovinazzo>
<The_Three_Stooges_in_Orbit>	<Edward_Bernds>
<The_Tiger's_Trail>	<Paul_Hurst_(actor)>
<The_Tiger's_Trail>	<Robert_Ellis_(actor)>
<The_Tiger's_Trail>	<Louis_J._Gasnier>
<The_Tigger_Movie>	<Jun_Falkenstein>
<The_Tingler>	<William_Castle>
<The_Tomb_of_Ligeia>	<Roger_Corman>
<The_Tortured>	<Robert_Lieberman>
<The_Trey_o'_Hearts>	<Wilfred_Lucas>
<The_Trey_o'_Hearts>	<Henry_MacRae>
<The_Tripper>	<David_Arquette>
<The_Triumph_of_Hercules>	<Alberto_De_Martino>
<The_Trollenberg_Terror>	<Quentin_Lawrence>
<The_Two_Faces_of_Dr._Jekyll>	<Terence_Fisher>
<The_Undead_(film)>	<Roger_Corman>
<The_Undercover_Man>	<Joseph_H._Lewis>
<The_Understanding_Heart>	<Jack_Conway_(filmmaker)>
<The_Undying_Monster>	<John_Brahm>
<The_Unnamable_(film)>	<Jean-Paul_Ouellette>
<The_Vampire_Bat>	<Frank_R._Strayer>
<The_Vampire_Lovers>	<Roy_Ward_Baker>
<The_Vanishing_Dagger>	<Eddie_Polo>
<The_Vanishing_Dagger>	<Edward_A._Kull>
<The_Vault_of_Horror_(film)>	<Roy_Ward_Baker>
<The_Visitation_(film)>	<Robby_Henson>
<The_Ward_(film)>	<John_Carpenter>
<The_Warlords>	<Peter_Chan>
<The_Warrior>	<Asif_Kapadia>
<The_Warriors_(film)>	<Walter_Hill_(filmmaker)>
<The_Watcher_in_the_Woods>	<John_Hough_(director)>
<The_Watcher_in_the_Woods>	<Vincent_McEveety>
<The_Water_Babies_(film)>	<Lionel_Jeffries>
<The_Werewolf_of_Washington>	<Milton_Moses_Ginsberg>
<The_White_Reindeer>	<Erik_Blomberg>
<The_White_Tower_(film)>	<Ted_Tetzlaff>
<The_Wicker_Tree>	<Robin_Hardy_(film_director)>
<The_Wild_Blue_Yonder>	<Werner_Herzog>
<The_Woman>	<Lucky_McKee>
<Thillalangadi>	<M._Raja>
<Thimiru>	<Tarun_Gopi>
<Things_Change>	<David_Mamet>
<Thirteen_Ghosts>	<Steve_Beck_(director)>
<This_Night_I'll_Possess_Your_Corpse>	<José_Mojica_Marins>
<Three_Cases_of_Murder>	<David_Eady_(film_director)>
<Three_Cases_of_Murder>	<Wendy_Toye>
<Three_Cases_of_Murder>	<George_More_O'Ferrall>
<Three_Fugitives>	<Francis_Veber>
<Thunderbirds_Are_Go>	<David_Lane_(director)>
<Tight_Spot>	<Phil_Karlson>
<Timecop>	<Peter_Hyams>
<Time_Bandits>	<Terry_Gilliam>
<Tintorera>	<René_Cardona_Jr.>
<Tito_(film)>	<Tarek_Al_Eryan>
<Tobor_the_Great>	<Lee_Sholem>
<Tokyo_Drifter>	<Seijun_Suzuki>
<Tomorrow,_When_the_War_Began_(film)>	<Stuart_Beattie>
<Tonka_(film)>	<Lewis_R._Foster>
<Too_Scared_to_Scream>	<Tony_Lo_Bianco>
<Top_Gun>	<Tony_Scott>
<Top_of_the_Food_Chain>	<John_Paizs>
<Torrid_Zone>	<William_Keighley>
<Torture_Garden_(film)>	<Freddie_Francis>
<Tourist_Trap_(film)>	<David_Schmoeller>
<Tower_of_Evil>	<Jim_O'Connolly>
<Toys_(film)>	<Barry_Levinson>
<To_the_Devil_a_Daughter>	<Peter_Sykes_(director)>
<Trailer_Park_of_Terror>	<Steven_Goldmann>
<Transylmania>	<Scott_Hillenbrand>
<Transylmania>	<David_Hillenbrand>
<Transylvania_Twist>	<Jim_Wynorski>
<Travels_with_My_Aunt_(film)>	<George_Cukor>
<Treasure_of_Matecumbe>	<Vincent_McEveety>
<Treasure_of_the_Four_Crowns>	<Ferdinando_Baldi>
<Treehouse_Hostage>	<Sean_McNamara_(director)>
<Trick_'r_Treat>	<Michael_Dougherty>
<Tridev>	<Rajiv_Rai>
<Trilogy_of_Terror_II>	<Dan_Curtis>
<Triple_Tap>	<Derek_Yee>
<Trog>	<Freddie_Francis>
<True_Lies>	<James_Cameron>
<Turkey_Shoot_(film)>	<Brian_Trenchard-Smith>
<Twice-Told_Tales_(film)>	<Sidney_Salkow>
<Twinkle,_Twinkle_Lucky_Stars>	<Chin_Kar-lok>
<Twinkle,_Twinkle_Lucky_Stars>	<Jackie_Chan>
<Twinkle,_Twinkle_Lucky_Stars>	<Yuen_Wah>
<Twinkle,_Twinkle_Lucky_Stars>	<Yuen_Biao>
<Twinkle,_Twinkle_Lucky_Stars>	<Sammo_Hung>
<Twinkle,_Twinkle_Lucky_Stars>	<Fruit_Chan>
<Twins_of_Evil>	<John_Hough_(director)>
<Two_Evil_Eyes>	<George_A._Romero>
<Two_Evil_Eyes>	<Dario_Argento>
<Two_Missionaries>	<Franco_Rossi>
<Two_on_a_Guillotine>	<William_Conrad>
<U.S._Marshals_(film)>	<Stuart_Baird>
<Undercover_X>	<Scott_Shaw>
<Underworld_U.S.A.>	<Samuel_Fuller>
<Under_Siege>	<Andrew_Davis_(film_director)>
<Undisputed_(film)>	<Walter_Hill_(filmmaker)>
<Unforgiven>	<Clint_Eastwood>
<Unknown_World>	<Terry_O._Morse>
<Untitled_(film)>	<Shaun_Troke>
<Up_to_His_Ears>	<Philippe_de_Broca>
<Urban_Explorer>	<Andy_Fetscher>
<Urban_Legend_(film)>	<Jamie_Blanks>
<Ustaad>	<Sibi_Malayil>
<Vaamanan>	<I._Mueenuddin_Ahmed>
<Vaasthavam>	<M._Padmakumar>
<Vacancy_(film)>	<Nimród_Antal>
<Valley_of_the_Kings_(film)>	<Robert_Pirosh>
<Valliettan>	<Shaji_Kailas>
<Vampira_(film)>	<Clive_Donner>
<Vampire_Noir>	<Scott_Shaw>
<Vampyres_(film)>	<José_Ramón_Larraz>
<Vampyros_Lesbos>	<Jesús_Franco>
<Vandhaan_Vendraan>	<R._Kannan>
<Vantage_Point_(film)>	<Pete_Travis>
<Varan_the_Unbelievable>	<Ishir?_Honda>
<Variola_Vera>	<Goran_Markovi?_(film_director)>
<Vengeance_of_the_Zombies>	<León_Klimovsky>
<Vexille>	<Fumihiko_Sori>
<Videodrome>	<David_Cronenberg>
<Vinyan>	<Fabrice_Du_Welz>
<Violent_Saturday>	<Richard_Fleischer>
<Virgin_Witch>	<Ray_Austin_(director)>
<Voodoo_Academy>	<David_DeCoteau>
<Voodoo_Moon>	<Kevin_VanHook>
<Voyage_to_the_Prehistoric_Planet>	<Curtis_Harrington>
<Voyage_to_the_Prehistoric_Planet>	<Pavel_Klushantsev>
<Vultures_of_the_Sea>	<Richard_Thorpe>
<Wacko_(film)>	<Greydon_Clark>
<Walker_(film)>	<Alex_Cox>
<Warlords_of_Atlantis>	<Kevin_Connor_(director)>
<Wasabi_(film)>	<Gérard_Krawczyk>
<Watusi_(film)>	<Kurt_Neumann_(director)>
<Weather_Is_Good_on_Deribasovskaya,_It_Rains_Again_on_Brighton_Beach>	<Leonid_Gaidai>
<Weird_Woman>	<Reginald_Le_Borg>
<Wendigo_(film)>	<Larry_Fessenden>
<Werewolf_of_London>	<Stuart_Walker_(filmmaker)>
<West_of_Shanghai>	<John_Farrow>
<Wes_Craven's_New_Nightmare>	<Wes_Craven>
<What_Lies_Beneath>	<Robert_Zemeckis>
<Where_Got_Ghost?>	<Jack_Neo>
<White_Line_Fever_(film)>	<Jonathan_Kaplan>
<White_Shadows_in_the_South_Seas>	<W._S._Van_Dyke>
<White_Shadows_in_the_South_Seas>	<Robert_J._Flaherty>
<White_Witch_Doctor_(film)>	<Henry_Hathaway>
<Whoever_Slew_Auntie_Roo?>	<Curtis_Harrington>
<Who_Saw_Her_Die?>	<Aldo_Lado>
<Wicked_City_(film)>	<Yoshiaki_Kawajiri>
<Witchboard>	<Kevin_S._Tenney>
<With_Stanley_in_Africa>	<Edward_A._Kull>
<With_Stanley_in_Africa>	<William_James_Craft>
<Wolf_Creek_(film)>	<Greg_McLean>
<Wolves_of_Wall_Street>	<David_DeCoteau>
<Wrath_of_the_Titans>	<Jonathan_Liebesman>
<Xtro>	<Harry_Bromley_Davenport>
<XXX_(film)>	<Rob_Cohen>
<X_the_Unknown>	<Les_Norman>
<X_the_Unknown>	<Joseph_Losey>
<Yavarum_Nalam>	<Vikram_Kumar>
<Year_of_the_Comet>	<Peter_Yates>
<Yellow_Faced_Tiger>	<Lo_Wei>
<Yogi_Bear_(film)>	<Eric_Brevig>
<Young_Frankenstein>	<Mel_Brooks>
<Young_Guns>	<Christopher_Cain>
<You_Don't_Mess_with_the_Zohan>	<Dennis_Dugan>
<Yugandhar>	<K._S._R._Das>
<Yurei_Otoko>	<Motoyoshi_Oda>
<Zanjeer>	<Prakash_Mehra>
<Zardoz>	<John_Boorman>
<Zeder>	<Pupi_Avati>
<Zeppelin_(film)>	<Étienne_Périer_(director)>
<Zombiegeddon>	<Chris_Watson>
<Zombieland>	<Ruben_Fleischer>
<Zombies_of_Mora_Tau>	<Edward_L._Cahn>
<Zombie_Lake>	<Jean_Rollin>
<Zombie_Strippers>	<Jay_Lee>
<Zurdo>	<Carlos_Salces>
